1111111111111111111111111111
1010000000C00000C11110000001
100000010000C1010000C0000C01
1000P0000000C1000C0000010C11
100000000000C1000100C000E001
100000000000C1000100C0000001
10000000000001000100C0000001
10000000000001000100C000C001
10000000000001000100C000C001
1111111111111111111111111111