111111111111111111111111111111111
1E0000000000000C00000C00000000011
101001010010000010100100001010111
101001001011010001010100000001011
1P0000010C00C0000000000C000010001
111111111111111111111111111111111