111111111111111111111111111111111
10E000000000000100000000000000011
101001010010000010100100001010111
101001001011010001010100000001011
1P00000101C0000000000000000010001
111111111111111111111111111111111