111111111111111111111111111111111
1E0000000000000C00000C00000000001
101001010010000010100100000100111
101001001010101000100100000001011
1P0000010C00C00000000000000010001
111111111111111111111111111111111