111111111111111111111111111111111
1000000000000000000C0000000010011
101001010010000010100100001010111
101001001011010001010100000001011
1EP000010000000000000000000010101
1111111111111111111111111111111111