11111111111111
1000000000C001
100000E00000C1
100000000000C1
10P000000000C1
11111111111111