1111111111111111111111111111
1010000000C00000C11110000001
100000010000C1010000C0000C01
1000P0000000C1000C0000010C11
10000000C000C1000100C0000001
100010000000C1000100C0000001
100010000C000100010000000001
10001000000001000100C000C001
1C0C1C000000010001C0C000C0E1
1111111111111111111111111111