11111111111111
1010000000C001
100000010000C1
1000P0000E00C1
100000000000C1
11111111111111