11111111111111
1E00000000C001
10000P000000C1
11111111111111