11111111111111
1010000000C001
100000010000C1
100000000E00C1
100P00000000C1
11111111111111