11111111111111111
1P0C0000000C11C11
10000000C0000C001
10E00000C0000C001
11111111111111111