11111111111111111
100C0000000C11C11
10000000C0000C001
10000000C0000C001
11111111111111111