1111111111111111111111111
1000000P00000000000000001
1111111111111111111011111
1C00000000000000000000CE1
1111111111111111111111111